#######################
#..........#..........#
#..........#..........# 
#..........#..........#
#..........#..........# 
#..........+..........#
#..........#..........# 
#..........#..........#
#..........#..........# 
#..........#..........#
#######################