#######################
#..........#..........#
#........../..........# 
#..........#..........#
#........../..........# 
#........../..........#
#..........#..........# 
#..........+..........#
#..........#..........# 
#........../..........#
#######################
