#######################
#..........#..........#
#........../..........# 
#..........#..........#
#........../..........# 
#........../..........#
#..........#..........# 
#..........|..........#
#..........#..........# 
#..........|..........#
#######################
